A la gurda: Refugio, guarida.
Abacanado: Presuntuosos.
Abanicar: Agente Policial.
Abanicarse: Irse.
Abanico: Soplon / Agente policial.
Abaragar: Parar con el cuchillo los golpes del adversario.
Abatatado: Asustado.
Abatatarse: Asustarse.
Ablandado: Asustado / Sobornado.
Ablandar: Sobornar.
Ablandarse: Asustarse.
Abocado: Irreflexivo.
Abocarse: Precipitarse.
Abombado: Tonto.
Abotonado: Casado (abrochado, acoyarado, casoriado).
Abotonarse: Casarse.
Abrancar: Atrapar.
Abricola: Distraido.
Abriles: sinonimo de años.
Abrir cancha: Despejar el sitio de una contienda.
Abrirse: Apartarse, desviarse, hacerse a un lado.
Abrochado: Casado.
Academia: Salones de baile, mujeres, tragos.
Acamala: Guardar, cargar.
Acamalador: Tacaño.
Acamalar: Acaparar / Proteger / Atrapar, asir / Ahorrar mezquinando.
Acamalarse: Amancebarse.
Acanalar: Herir con arma blanca.
Aceitado: Sobornado.
Aceitar los patines: Prostituir, cafishiar.
Aceitar: Sobornar.
Aceite, dar el: Despido.
Aceite, tomarse el: Irse rapidamente.
Aceite: Soborno.
Aceitosa: Cabeza.
Aceitunas, cambiar el agua de las: Orinar.
Aceitunas, le dieron las: Despido.
Aceitunas, tomarse las: Irse rapidamente.
Achacado: Achacoso.
Achacador: Malhechor.
Achaco: Robo.
Achicar: Acobardar.
Achuchado: Asustado.
Achumado: Ebrio.
Achumarse: Embriagarse.
Achurar: Asesinar.
Acomodado: Recomendado.
Acomodar: Recomendar, influenciar / Zurrar.
Acomodo: Influencia favorable.
Acoyarado: Casado.
Acoyarse: Casarse.
Acuñado: Recomendado.
Acuñar: Recomendar, favorecer.
Adicion: Factura de gastos del restaurante.
Adobado: Ebrio.
Adobarse: Embriagarse.
Adornado: Sobornado.
Adorno: Soborno.
Afanancio: Ladron.
Afano: Robo.
Afiambrar: Matar.
Afiambrado: Asesinado.
Afilador: Cortejante.
Afilar: Festejar.
Aflojar: Delatar.
Afrecho: Apetito sexual.
Afrechudo: Rijoso.
Africar: Entregar con fuerza.
Agachada: Deslealtad, vileza.
Agarrada: Disputa.
Agayas, de: Valiente.
Agayudo: Valiente.
Agrampar: Atrapar, asir.
Agrandado: Ostentoso.
Aguantiñar: Afrontar, soportar.
Aguila / Aguilero: Indigente.
Ainenti: Piedritas (Juego de niños).
Al bardo: Salir a robar sin un plan determinado:.
Al pucho: De inmediato.
Alacran: Chismoso.
Alacranear: Chismosear.
Alacransar: Hablar mal.
Alambrada: Guitarra.
Alca: Alcahuete.
Alcachofa: Alcahuete.
Alcagüeteria: Delacion.
Alcancia: Carcel.
Alcaucil: Alcahuete.
Alce: Ocasion.
Alfajia: Alto.
Alfiler: Arma blanca.
Aliviar: Robar.
Almanaques: Edad, años.
Alpedologia: Hablar sobre un tema sin conocimiento.
Alpiste: Bebida alcoholica.
Alpisteria: Bar, licoreria.
Alpistero: Ebrio.
Altiyero: Excelente.
Altiyo: Cabeza.
Alumbrante: Fosforo.
Alumbrar: Proveer dinero.
Alzado: Rijoso.
Alzarse: Irse.
Amachimbrado: Amancebado.
Amargo: Cobarde.
Amarrete: Tacaño.
Amarretear: Mezquinar.
Amarretismo: Mezquindad.
Amarro: Tacaño.
Amarrocador: Tacaño.
Amarrocar: Atesorar.
Amarroto: Amarrete / Tacaño.
Amasijado: Asesinado / Zurrado.
Amasijar: Zurrar / Matar.
Amasijo: Castigo, zurra.
Ambidextro: Pederasta, activo y pasivo.
Ambiguo: Afeminado.
Amueblada: Albergue transitorio.
Amurado: Abandonado.
Amuro: Carcel.